
Season,Age,Tm,Lg,Pos,G,GS,MP,FG,FGA,FG%,3P,3PA,3P%,2P,2PA,2P%,FT,FTA,FT%,ORB,DRB,TRB,AST,STL,BLK,TOV,PF,PTS
1989-90 ★,24,SAS,NBA,C,82,81,3002,690,1300,.531,0,2,.000,690,1298,.532,613,837,.732,303,680,983,164,138,319,257,259,1993
1990-91 ★,25,SAS,NBA,C,82,81,3095,754,1366,.552,1,7,.143,753,1359,.554,592,777,.762,335,728,1063,208,127,320,270,264,2101
1991-92 ★,26,SAS,NBA,C,68,68,2564,592,1074,.551,1,8,.125,591,1066,.554,393,561,.701,261,568,829,181,158,305,182,219,1578
1992-93 ★,27,SAS,NBA,C,82,82,3211,676,1348,.501,3,17,.176,673,1331,.506,561,766,.732,229,727,956,301,127,264,241,239,1916
1993-94 ★,28,SAS,NBA,C,80,80,3241,840,1658,.507,10,29,.345,830,1629,.510,693,925,.749,241,614,855,381,139,265,253,228,2383
1994-95 ★,29,SAS,NBA,C,81,81,3074,788,1487,.530,6,20,.300,782,1467,.533,656,847,.774,234,643,877,236,134,262,233,230,2238
1995-96 ★,30,SAS,NBA,C,82,82,3019,711,1378,.516,3,9,.333,708,1369,.517,626,823,.761,319,681,1000,247,111,271,190,262,2051
1996-97,31,SAS,NBA,C,6,6,147,36,72,.500,0,0,,36,72,.500,34,52,.654,19,32,51,8,6,6,8,9,106
1997-98 ★,32,SAS,NBA,C,73,73,2457,544,1065,.511,1,4,.250,543,1061,.512,485,660,.735,239,536,775,199,64,192,202,204,1574
1998-99,33,SAS,NBA,C,49,49,1554,268,527,.509,0,1,.000,268,526,.510,239,363,.658,148,344,492,103,69,119,108,143,775
1999-00 ★,34,SAS,NBA,C,80,80,2557,528,1031,.512,0,2,.000,528,1029,.513,371,511,.726,193,577,770,142,97,183,164,247,1427
2000-01 ★,35,SAS,NBA,C,80,80,2371,400,823,.486,0,1,.000,400,822,.487,351,470,.747,208,483,691,116,80,197,122,212,1151
2001-02,36,SAS,NBA,C,78,78,2303,341,672,.507,0,0,,341,672,.507,269,395,.681,191,456,647,94,86,140,104,193,951
2002-03,37,SAS,NBA,C,64,64,1676,197,420,.469,0,0,,197,420,.469,152,214,.710,163,345,508,61,52,111,83,126,546
Career,,,NBA,,987,985,34271,7365,14221,.518,25,100,.250,7340,14121,.520,6035,8201,.736,3083,7414,10497,2441,1388,2954,2417,2835,20790